1111111111
1C00000001
1000P00001
1000000EC1
1111111111
